0,0,0,0,0,0,0,0,0,0,0,0,0,0,0,0,0,0,0,0,0,0,0,0,0,0,0,0,0,0
0,6,7,7,2,2,2,2,2,2,0,5,4,4,4,4,4,4,5,0,2,2,2,2,2,2,7,7,6,0
0,7,8,2,2,2,2,2,2,4,0,4,4,4,4,4,4,4,4,0,4,2,2,2,2,2,2,8,7,0
0,7,2,2,2,3,2,2,2,4,4,4,4,4,4,4,4,4,4,4,4,2,2,3,3,3,2,2,7,0
0,2,2,2,3,2,3,2,2,2,4,4,4,4,4,4,4,4,4,4,3,2,2,3,10,3,2,2,2,0
0,2,2,2,2,3,2,2,2,2,4,4,4,4,4,4,4,4,4,4,3,2,2,3,3,3,2,2,2,0
0,2,2,2,2,2,2,2,2,4,4,4,4,4,4,4,4,4,4,4,4,2,2,2,2,2,2,2,2,0
0,2,2,2,2,2,2,7,7,5,1,4,4,4,4,4,4,4,4,1,5,7,7,2,2,2,2,2,2,0
0,6,2,4,4,2,4,4,7,5,0,4,4,4,4,4,4,4,4,0,5,7,4,4,2,4,4,2,6,0
0,1,1,1,4,4,4,1,1,1,0,4,4,4,5,5,4,4,4,0,1,1,1,4,4,4,1,1,1,0
0,0,0,0,4,4,4,0,0,0,0,4,4,4,5,5,4,4,4,0,0,0,0,4,4,4,0,0,0,0
0,6,2,4,4,2,5,4,7,4,0,4,4,4,4,4,4,4,4,0,5,7,4,4,2,4,4,2,6,0
0,2,2,2,2,2,2,7,7,4,0,4,4,4,4,4,4,4,4,0,5,7,7,2,2,2,2,2,2,0
0,2,2,2,2,2,2,2,2,5,4,4,4,4,4,4,4,4,4,4,4,2,2,2,2,2,2,2,2,0
0,2,2,2,2,2,2,2,2,2,4,4,4,4,4,4,4,4,4,4,2,2,2,2,3,2,2,2,2,0
0,2,2,2,2,2,2,2,2,2,4,4,4,4,4,4,4,4,4,4,2,2,2,3,2,3,2,2,2,0
0,7,2,2,2,2,2,2,2,4,4,4,4,4,4,4,4,4,4,4,4,2,2,2,3,2,2,2,7,0
0,7,9,2,2,2,2,2,2,4,1,4,4,4,4,4,4,4,4,1,4,2,2,2,2,2,2,8,7,0
0,6,7,7,2,2,2,2,2,4,0,5,4,4,4,4,4,4,5,0,4,2,2,2,2,2,7,7,6,0
0,1,1,1,1,1,1,1,1,1,0,1,1,1,1,1,1,1,1,0,1,1,1,1,1,1,1,1,1,0
