0,0,0,0,0,0,0,0,0,0,0,0,0,0,0,0,0,0,0,0,0,0,0,0,0,0,0,0,0,0
0,4,7,7,2,2,2,2,2,3,0,4,4,4,4,4,4,4,4,0,3,2,2,2,2,2,7,7,4,0
0,7,8,2,2,2,2,2,2,6,0,4,4,4,4,4,4,4,4,0,6,2,2,2,2,2,2,8,7,0
0,7,2,2,2,2,2,2,2,4,4,4,4,4,4,4,4,4,4,4,4,2,2,2,2,2,2,2,7,0
0,2,2,2,3,3,6,2,2,3,5,4,4,4,4,4,4,4,4,5,3,2,2,6,6,6,2,2,2,0
0,2,2,2,3,3,6,2,2,3,5,4,4,4,4,4,4,4,4,5,3,2,2,5,10,6,2,2,2,0
0,2,2,2,2,2,2,2,2,4,4,4,4,4,4,4,4,4,4,4,4,2,2,5,5,6,2,2,2,0
0,2,2,2,2,2,2,7,7,6,1,4,4,4,4,4,4,4,4,1,6,7,7,2,2,2,2,2,2,0
0,2,2,6,4,2,4,6,7,4,0,4,4,5,5,5,5,4,4,0,4,7,6,4,3,4,6,2,3,0
0,1,1,1,4,4,4,1,1,1,0,4,4,5,5,5,5,4,4,0,1,1,1,4,5,4,1,1,1,0
0,0,0,0,4,4,4,0,0,0,0,4,4,5,5,5,5,4,4,0,0,0,0,4,5,4,0,0,0,0
0,2,2,6,4,2,4,6,7,4,0,4,4,5,5,5,5,4,4,0,4,7,6,4,3,4,6,2,3,0
0,2,2,2,2,2,2,7,7,6,0,4,4,4,4,4,4,4,4,0,6,7,7,2,2,2,2,2,2,0
0,2,2,2,2,2,2,2,2,4,5,4,4,4,4,4,4,4,4,4,4,2,2,2,2,2,2,2,2,0
0,2,2,2,2,6,2,2,2,2,4,4,4,4,4,4,4,4,4,5,3,2,2,6,3,3,2,2,2,0
0,2,2,2,2,6,2,2,2,2,4,4,4,4,4,4,4,4,4,5,3,2,2,6,3,3,2,2,2,0
0,7,2,2,2,2,2,2,2,4,5,4,4,4,4,4,4,4,4,4,4,2,2,2,2,2,2,2,7,0
0,7,9,2,2,2,2,2,2,6,1,4,4,4,4,4,4,4,4,1,6,2,2,2,2,2,2,8,7,0
0,4,7,7,2,2,2,2,2,2,0,4,4,4,4,4,4,4,4,0,3,2,2,2,2,2,7,7,4,0
0,1,1,1,1,1,1,1,1,1,0,1,1,1,1,1,1,1,1,0,1,1,1,1,1,1,1,1,1,0
