0,0,0,0,0,0,0,0,0,0,0,0,0,0,0,0,0,0,0,0,0,0,0,0,0,0,0,0,0,0
0,0,0,0,0,0,0,0,0,0,0,0,0,0,0,0,0,0,0,0,0,0,0,0,0,0,0,0,0,0
0,0,6,6,2,2,7,8,8,7,2,2,6,6,0,0,3,3,2,2,2,2,2,2,2,2,3,3,0,0
0,0,6,2,2,2,7,7,7,7,2,2,2,6,0,0,3,2,2,2,2,2,2,2,2,2,2,3,0,0
0,0,2,2,2,2,6,6,6,6,2,2,2,2,4,5,2,2,2,2,2,2,2,2,2,2,2,2,0,0
0,0,2,2,2,2,2,2,2,2,2,2,2,2,4,4,2,2,2,2,2,2,2,2,2,2,2,2,0,0
0,0,2,2,2,2,2,2,2,2,2,2,2,2,4,4,2,2,2,2,2,2,2,2,2,2,2,2,0,0
0,0,2,2,2,2,2,2,2,2,2,2,2,2,4,4,2,2,2,2,2,2,2,2,2,2,2,2,0,0
0,0,2,2,2,2,2,7,7,2,2,2,2,2,4,4,2,2,2,2,3,3,3,3,2,2,2,2,0,0
0,0,6,2,2,2,7,6,6,7,2,2,2,2,4,5,2,2,2,2,3,6,6,3,2,2,2,2,0,0
0,0,9,2,2,2,7,6,6,7,2,2,2,2,4,5,2,2,2,2,3,6,10,3,2,2,2,2,0,0
0,0,2,2,2,2,2,7,7,2,2,2,2,2,4,4,2,2,2,2,3,3,3,3,2,2,2,2,0,0
0,0,2,2,2,2,2,2,2,2,2,2,2,2,4,4,2,2,2,2,2,2,2,2,2,2,2,2,0,0
0,0,2,2,2,2,2,2,2,2,2,2,2,2,4,4,2,2,2,2,2,2,2,2,2,2,2,2,0,0
0,0,2,2,2,2,2,2,2,2,2,2,2,2,4,4,2,2,2,2,2,2,2,2,2,2,2,2,0,0
0,0,2,2,2,2,6,6,6,6,2,2,2,2,4,5,2,2,2,2,2,2,2,2,2,2,2,2,0,0
0,0,6,2,2,2,7,7,7,7,2,2,2,6,1,1,3,2,2,2,2,2,2,2,2,2,2,3,0,0
0,0,6,6,2,2,7,8,8,7,2,2,6,6,0,0,3,3,2,2,2,2,2,2,2,2,3,3,0,0
0,0,1,1,1,1,1,1,1,1,1,1,1,1,0,0,1,1,1,1,1,1,1,1,1,1,1,1,0,0
0,0,0,0,0,0,0,0,0,0,0,0,0,0,0,0,0,0,0,0,0,0,0,0,0,0,0,0,0,0
